TTTTTTTTTTTTTTTTTTTT
T####f######f###TTTT
T###RTf######f###TTT
T#f###############TT
T############TRT##TT
T#################TT
T###R############TTT
TTT#############TTTT
TTTTTTTTTTTTTTTTTTTT
TTTTTTTTTTTTTTTTTTTT