TTTTTTTTTTTTTTTTTTTT
T####f######f###TTTT
T###RTf######f###TTT
T#f###############TT
T#######R####TRT##TT
T#################TT
T###R############TTT
T###############TTTT
TTTTTTTTTTTTTTTTTTTT
TTTTTTTTTTTTTTTTTTTT