TTTTTTTTTTTTTTTTTTT
T               TTT
T   RT           TT
T                 T
T       R    TRT  T
T                 T
T   R            TT
T               TTT
TTTTTTTTTTTTTTTTTTT
TTTTTTTTTTTTTTTTTTT